

SO     ./textures/so.xpm

NO ./textures/no.xpm
EA ./textures/ea.xpm
WE ./textures/we.xpm

F 2,2,0
C   255,30,0


        1111111111111111111111111
  11    1000000000110000000000001
  11    1011000001110000000000001
  11    1001000000000000000000001
111111111011000001110000000000001
100000000011000001110111111111111
11111111111110111000000100001
       1111111011101010010001
       1110101011100000010001
11111110000000001100000010001
10000000000000001101010010001
100001111111111000000100011111111
100001        1000001101010010001
100001        1000001100000010001
100001        1000001101010010001
100001111111111000000100011111111
10000000000000001101010010001
10000000000000001100000010001
10000000000000001101010010001
11000001111101011111011110N0111
11110111   11001 101111010001
11111111    1111 111111111111
